_______X__X
___XXX_____
XXXG___X___
__XXXXX____
___X_____X_
__S__X_____
