G______X
___XXX__
XXX____X
__XXXX__
___X____
__S__X__
